COUNTRY NAME	ISO2_code
PALAU	PW
INDONESIA	
FIJI	FJ
CHILE	
FEDERATED STATES OF MICRONESIA	FM
Wallis and Futuna (FRANCE)	WF
TOKELAU (NEW ZEALAND)	TK
TONGA	TN
SAMOA	WS
Niue (NEW ZEALAND)	NU
NEW ZEALAND	NZ
French Polynesia (FRANCE)	PF
Cook Islands (NEW ZEALAND)	CK
American Samoa (US)	AS
UNITED STATES	US
VANUATU	VU
TUVALU	TV
SOLOMON ISLANDS	SB
PAPUA NEW GUINEA	PG
Northern Mariana Islands (US)	MP
New Caledonia (FRANCE)	NC
NAURU	NR
MARSHALL ISLANDS	MH
KIRIBATI	KI
Guam (US)	GU
